+--+--+--+--+--+--+--+--+--+--+--+--+--+--+--+--+--+--+--+--+
   |     |     |        |           |  |     |           |  |
+  +  +  +  +  +--+  +  +  +--+--+  +  +  +  +--+--+--+  +  +
|     |  |  |     |  |  |  |     |        |  |        |  |  |
+--+--+  +  +--+  +  +  +  +  +  +--+--+--+  +  +  +--+  +  +
|        |  |  |  |  |     |  |  |           |  |     |  |  |
+  +--+--+  +  +  +  +--+--+--+  +  +--+--+  +  +--+  +  +  +
|  |           |     |        |        |  |     |  |  |     |
+  +  +  +--+--+--+--+  +--+  +--+--+  +  +--+--+  +  +  +--+
|     |  |           |  |              |        |  |     |  |
+--+--+  +  +--+--+  +  +--+--+--+--+--+--+--+  +  +--+--+  +
|     |  |  |        |  |     |              |  |           |
+  +  +  +  +--+--+--+  +  +  +--+--+--+--+  +  +--+--+  +--+
|  |  |  |  |        |     |     |        |  |        |  |  |
+  +  +  +  +  +--+  +--+--+--+  +  +--+  +  +  +--+  +  +  +
|  |  |  |     |     |        |  |  |     |  |  |     |  |  |
+  +--+  +--+--+  +  +  +--+--+  +--+  +  +  +  +--+--+  +  +
|        |     |  |     |        |     |     |     |  |     |
+  +--+--+  +  +  +--+--+  +--+  +  +--+  +--+--+  +  +--+  +
|        |  |  |           |     |     |     |        |     |
+--+--+  +  +--+--+--+--+--+  +--+--+  +--+--+  +--+--+  +--+
|  |     |     |        |     |     |     |     |        |  |
+  +  +--+  +  +  +--+  +  +--+--+  +--+  +  +--+  +--+--+  +
|     |     |     |     |        |  |     |  |           |  |
+--+  +  +--+--+--+  +--+--+--+  +  +  +--+  +  +  +--+  +  +
|     |     |        |        |  |  |     |     |  |     |  |
+  +--+--+  +  +--+--+  +--+--+  +  +--+  +  +--+  +  +--+  +
|        |  |  |     |           |        |  |     |     |  |
+--+--+  +  +  +  +  +--+--+--+--+  +--+--+--+  +--+--+  +  +
|     |  |  |  |  |  |     |     |  |     |     |        |  |
+  +--+  +  +  +  +  +  +  +  +  +  +--+  +  +--+--+--+--+  +
|     |     |     |     |     |        |  |                 |
+--+  +--+--+--+--+--+--+--+--+--+  +  +  +--+--+--+  +--+--+
|  |                    |        |  |  |     |        |     |
+  +--+--+--+  +--+--+  +  +--+  +  +  +--+  +  +--+--+  +  +
|  |  |     |     |  |  |  |  |     |     |  |  |        |  |
+  +  +  +  +--+  +  +  +  +  +--+--+  +  +  +  +--+--+--+  +
|        |     |     |        |        |  |  |     |     |  |
+--+  +--+--+  +--+--+--+  +--+--+--+--+  +  +--+  +  +  +  +
|           |              |                          |      
+--+--+--+--+--+--+--+--+--+--+--+--+--+--+--+--+--+--+--+--+