
■■■■■■■■■■■■■■■■■■■■■■■■■■■■■■■■■■■■■■■■■
□□■□□□■   ■     ■       ■ ■   ■       ■ ■
■□■□■□■ ■ ■■■ ■ ■ ■■■■■ ■ ■ ■ ■■■■■■■ ■ ■
■□□□■□■ ■   ■ ■ ■ ■   ■     ■ ■     ■ ■ ■
■■■■■□■ ■■■ ■ ■ ■ ■ ■ ■■■■■■■ ■ ■ ■■■ ■ ■
■□□□□□■ ■ ■ ■ ■   ■ ■ ■       ■ ■   ■ ■ ■
■□■■■■■ ■ ■ ■ ■■■■■■■ ■ ■■■■■ ■ ■■■ ■ ■ ■
■□■□□□    ■   ■     ■     ■ ■   ■ ■ ■   ■
■□■□■□■■■■■■■■■ ■■■ ■■■■■ ■ ■■■■■ ■ ■ ■■■
■□□□■□■       ■ ■         ■     ■ ■   ■ ■
■■■■■□■ ■■■■■ ■ ■■■■■■■■■■■■■■■ ■ ■■■■■ ■
■   ■□■ ■     ■ ■   ■         ■ ■       ■
■ ■ ■□■ ■■■■■■■ ■ ■ ■■■■■■■■■ ■ ■■■■■ ■■■
■ ■ ■□■ ■     ■   ■   ■     ■ ■     ■ ■ ■
■ ■ ■□■ ■ ■■■ ■■■■■■■ ■ ■■■ ■ ■ ■■■ ■ ■ ■
■ ■ ■□■   ■   ■     ■ ■ ■   ■ ■ ■   ■ ■ ■
■ ■■■□■■■■■ ■ ■ ■■■■■ ■■■ ■ ■ ■ ■■■■■ ■ ■
■□□□□□■   ■ ■   ■     ■   ■   ■   ■ ■   ■
■□■■■■■ ■ ■ ■■■■■ ■■■ ■ ■■■ ■■■■■ ■ ■■■ ■
■□□□□□■ ■ ■       ■   ■   ■   ■     ■   ■
■■■■■□■ ■■■■■■■■■■■ ■■■■■ ■■■■■ ■■■■■ ■■■
■ ■□□□■□□□■□□□□□■   ■   ■   ■   ■     ■ ■
■ ■□■■■□■□■□■■■□■ ■■■■■ ■■■ ■ ■■■ ■■■■■ ■
■  □■□□□■□□□■□□□■     ■ ■   ■ ■       ■ ■
■■■□■□■■■■■■■□■■■■■■■ ■ ■ ■■■ ■ ■ ■■■ ■ ■
■□□□■□□□■□□□□□■     ■ ■ ■   ■   ■ ■   ■ ■
■□■■■■■□■□■■■■■ ■■■■■ ■ ■■■ ■ ■■■ ■ ■■■ ■
■□□□□□■□■□■□□□■       ■     ■ ■   ■   ■ ■
■■■■■□■□■□■□■□■■■■■■■■■ ■■■■■■■ ■■■■■ ■ ■
■   ■□■□■□■□■□■□□□■□□□■ ■   ■   ■     ■ ■
■ ■■■□■□■□■□■□■□■□■□■□■ ■■■ ■ ■■■■■■■■■ ■
■   ■□□□■□□□■□□□■□□□■□□□□□■ ■           ■
■■■ ■■■■■■■■■■■■■■■■■■■ ■□■ ■■■■■■■ ■■■■■
■ ■             ■     ■ ■□■   ■     ■   ■
■ ■■■■■■■ ■■■■■ ■ ■■■ ■ ■□■■■ ■ ■■■■■ ■ ■
■ ■ ■   ■   ■ ■ ■ ■ ■   ■□□□■ ■ ■     ■ ■
■ ■ ■ ■ ■■■ ■ ■ ■ ■ ■■■■■ ■□■ ■ ■■■■■■■ ■
■     ■   ■   ■     ■     ■□■ ■   ■□□□■ ■
■■■ ■■■■■ ■■■■■■■ ■■■■■■■■■□■ ■■■ ■□■□■ ■
■       ■         ■        □□□□□□□□□■□□□□
■■■■■■■■■■■■■■■■■■■■■■■■■■■■■■■■■■■■■■■■■